1111111111111111111111111111
111000000000000100000100X0C1
10E00P001C000001000XC00X1011
11100001C1100000000000000011
100000C1000000000C00000000C1
1111111111111111111111111111
